####################
#                  #
#                  #
#  PXO         #####
#                  #
#                  #
#                  #
#                  #
#                  #
#                  #
#                  #
#   OX             #
#                  #
#                  #
#                  #
####################
