*XXXXXXXX*XXXXX
***************
XXX*XX*XXXXXXXX
***************
XXXXXXXXX*XXXX*
***************
XXXXXXXXXXXXX**
***************
XXXXXXXXXXX*XXX
***************
XXXX*X*XXXXXXXX
***************
*XXXXXXXXXXXX*X
***************
XXXXXXXXXXXXXX*
